##########
#        #
#        #
#        #
#        #
#        #
#  c     #
#        #
#        #
##########
